+-+-+-+-+
|   | | |
+-+ + + +
| |   | |
+ + + + +
|   | | |
+-+-+ + +
| |   | |
+ +-+ + +
| |     |
+ + + + +
|   | | |
+-+-+-+-+
